A	AH
A(2)	EY
ACEY	EY S IY
ALAMO	AE L AH M OW
ALL	AO L
ALLEMANDE	AE L AH M AH N D
AN	AE N
AN(2)	AH N
AND	AH N D
AND(2)	AE N D
ARE	AA R
ARM	AA R M
AROUND	ER AW N D
AROUND(2)	ER AW N
AS	AE Z
AS(2)	EH Z
BACK	B AE K
BACKTRACK	B AE K T R AE K
BALANCE	B AE L AH N S
BEND	B EH N D
BOAT	B OW T
BOX	B AA K S
BOYS	B OY Z
BRACKET	B R AE K IH T
BY	B AY
CALIFORNIA	K AE L AH F AO R N Y AH
CALL	K AO L
CAN	K AE N
CAN(2)	K AH N
CANCEL	K AE N S AH L
CANCEL(2)	K AH N S AH L
CAST	K AE S T
CENTER	S EH N T ER
CENTER(2)	S EH N ER
CENTERS	S EH N T ER Z
CENTERS(2)	S EH N ER Z
CHAIN	CH EY N
CHASE	CH EY S
CIRCLE	S ER K AH L
CIRCULATE	S ER K Y AH L EY T
CLOVERLEAF	K L OW V ER L IY F
CLUTCH	K L AH CH
COORDINATE	K OW AO R D AH N AH T
COORDINATE(2)	K OW AO R D AH N EY T
CORNER	K AO R N ER
COUPLE	K AH P AH L
COUPLES	K AH P AH L Z
COURTESY	K ER T AH S IY
CROSS	K R AO S
CROSSFIRE	K R AO S F AY R
CUT	K AH T
CYCLE	S AY K AH L
DEAL	D IY L
DEUCEY	D IY Y UW S IY
DIAMOND	D AY M AH N D
DIVE	D AY V
DIXIE	D IH K S IY
DO	D UW
DODGE	D AA JH
DOPASO	D OW P AE S OW
DOSADO	D OW S AH D OW
DOUBLE	D AH B AH L
DOWN	D AW N
EIGHT	EY T
END	EH N D
ENDS	EH N D Z
EVERYBODY	EH V R IY B AA D IY
EXCHANGE	IH K S CH EY N JH
EXPLODE	IH K S P L OW D
EXTEND	IH K S T EH N D
FACE	F EY S
FACING	F EY S IH NG
FAN	F AE N
FERRIS	F EH R IH S
FILE	F AY L
FIRST	F ER S T
FIVE	F AY V
FLIP	F L IH P
FLUTTER	F L AH T ER
FLUTTERWHEEL	F L AH T ER W IY L
FOLD	F OW L D
FOLLOW	F AA L OW
FORWARD	F AO R W ER D
FOUR	F AO R
GEARS	G IH R Z
GIRLS	G ER L Z
GNAT	N AE T
GNAT(2)	G N AE T
GO	G OW
GRAND	G R AE N D
HALF	HH AE F
HAND	HH AE N D
HEAD	HH EH D
HEADS	HH EH D Z
HINGE	HH IH N JH
IN	IH N
INSIDE	IH N S AY D
INSIDES	IH N S AY D Z
JUST	JH AH S T
JUST(2)	JH IH S T
LADY	L EY D IY
LADIES	L EY D IY Z
LAST	L AE S T
LEAD	L EH D
LEAD(2)	L IY D
LEFT	L EH F T
LINE	L AY N
LINEAR	L IH N IY ER
LOAD	L OW D
MAKE	M EY K
MEN	M EH N
MORE	M AO R
NEIGHBOR	N EY B ER
NEXT	N EH K S T
NEXT(2)	N EH K S
OCEAN	OW SH AH N
OFF	AO F
ONCE	W AH N S
ONE	W AH N
ONE(2)	HH W AH N
OUT	AW T
OUTSIDE	AW T S AY D
OUTSIDES	AW T S AY D Z
PAIR	P EY R
PARTNER	P AA R T N ER
PASO	P AE S OW
PASS	P AE S
PEEL	P IY L
PING	P IH NG
PONG	P AO NG
PROMENADE	P R AA M AH N EY D
QUARTER	K W AO R T ER
QUARTERS	K W AO R T ER Z
RECYCLE	R IY S AY K AH L
RELAY	R IY L EY
REVERSE	R IH V ER S
REVERSE(2)	R IY V ER S
RIGHT	R AY T
RING	R IH NG
ROLL	R OW L
ROLLAWAY	R OW L AH W EY
RUN	R AH N
SASHAY	S AE SH EY
SAW	S AO
SCOOT	S K UW T
SEE	S IY
SEPARATE	S EH P ER EY T
SEPARATE(2)	S EH P ER IH T
SEPARATE(3)	S EH P R AH T
SET	S EH T
SEVEN	S EH V IH N
SEVEN(2)	S EH V AH N
SHOOT	SH UW T
SIDE	S AY D
SIDES	S AY D Z
SINGLE	S IH NG G AH L
SIX	S IH K S
SLIDE	S L AY D
SLIP	S L IH P
SPIN	S P IH N
SPLIT	S P L IH T
SPREAD	S P R EH D
SQUARE	S K W EH R
STAR	S T AA R
START	S T AA R T
STEP	S T EH P
STYLE	S T AY L
SWEEP	S W IY P
SWING	S W IH NG
TAG	T AE G
TEACUP	T IY K AH P
THAR	DH AA R
THAT	DH AE T
THE	DH AH
THE(2)	DH IY
THEY	DH EY
THOSE	DH OW Z
THREE	TH R IY
THRU	TH R UW
TO	T UW
TO(2)	T IH
TO(3)	T AH
TOP	T AA P
TOP(2)	T AO P
TOUCH	T AH CH
TRACK	T R AE K
TRADE	T R EY D
TURN	T ER N
TWIRL	T W ER L
TWO	T UW
U	Y UW
UNDO	AH N D UW
VEER	V IH R
WALK	W AO K
WALK(2)	W AA K
WAVE	W EY V
WAY	W EY
WEAVE	W IY V
WHEEL	W IY L
WHEEL(2)	HH W IY L
WHO	HH UW
WRONG	R AO NG
YOUR	Y AO R
YOUR(2)	Y UH R
ZOOM	Z UW M
